107
25
23 24 24 24 24 24 24 24 24 24 24 24 24 24 24 24 24 24 24 24 24 24 24 24 24 24 24 24 24 24 24 24 24 24 24 24 24 24 24 24 24 24 25 03 22 22 22 22 22 22 22 22 21 21 22 21 22 22 22 22 22 22 22 22 22 22 22 22 22 22 22 22 22 22 22 02 23 24 24 24 24 24 24 24 24 24 24 24 24 25 03 22 22 22 22 22 22 22 22 22 22 22 22 22 22 22 22
28 00 00 00 00 00 00 00 00 00 00 00 00 00 00 00 00 00 00 00 00 00 00 00 00 00 00 00 00 00 00 00 00 00 00 00 00 00 00 00 00 00 00 00 03 22 22 22 22 22 22 22 22 21 22 22 21 22 22 22 02 00 00 00 00 00 00 00 00 00 03 22 22 22 22 02 00 00 00 00 00 00 00 00 00 00 00 00 00 00 00 03 22 22 22 22 07 00 00 00 00 00 00 00 00 03 22
28 00 00 00 00 00 00 00 00 00 00 00 00 00 00 00 00 00 00 00 00 00 00 00 00 00 00 00 00 00 00 00 00 00 00 00 00 00 00 00 00 00 00 00 00 00 00 00 03 22 22 22 22 22 21 22 22 22 22 22 02 00 00 00 00 00 00 00 00 00 00 00 03 22 22 02 00 00 00 00 00 00 00 00 00 00 00 00 00 00 00 00 00 00 00 00 00 00 00 00 00 00 00 00 00 03 21
28 00 00 00 00 00 00 00 00 00 00 00 00 00 00 00 00 00 00 00 00 00 00 00 00 00 00 00 00 00 00 00 00 00 00 00 00 00 00 00 00 00 00 00 00 00 00 00 00 00 00 00 00 00 00 00 00 00 00 00 00 00 00 00 00 00 00 00 00 00 00 00 00 00 00 00 00 00 00 00 00 00 00 00 03 21 21 21 21 02 00 00 00 03 22 22 22 02 00 00 23 24 25 00 00 03 22
28 00 00 00 00 00 00 00 00 00 00 00 00 00 00 00 00 00 00 00 00 00 00 00 00 00 00 23 24 24 25 00 00 23 25 00 00 00 00 00 00 00 00 00 00 00 00 00 00 00 00 00 00 00 00 00 00 00 00 00 00 00 00 00 00 00 23 24 24 24 25 00 00 00 00 00 00 00 00 23 24 25 00 00 00 00 00 00 00 00 00 00 00 00 00 00 00 00 00 00 00 00 00 00 00 03 21
28 00 00 00 00 00 00 00 00 00 00 00 00 00 00 00 00 00 00 00 00 00 00 00 00 00 00 00 00 00 00 00 00 00 00 00 00 00 00 23 24 25 00 00 00 00 00 00 00 00 00 00 23 25 00 00 23 25 00 00 00 00 00 00 00 00 00 00 00 00 00 00 00 00 00 00 00 00 00 00 00 00 00 00 00 00 00 00 00 00 03 22 22 02 00 00 00 00 00 00 00 00 00 00 00 00 26
28 00 00 00 00 00 29 00 00 00 00 00 00 00 00 00 00 23 25 00 03 21 21 21 21 02 00 00 00 03 21 21 02 00 00 03 21 21 21 02 00 00 03 21 21 21 02 03 21 02 00 00 00 00 00 00 00 00 00 00 00 03 21 22 22 02 00 00 00 00 00 00 00 00 03 21 22 02 00 00 00 00 00 03 21 21 21 02 00 00 00 00 00 00 00 00 00 00 00 00 00 00 00 00 00 00 27
22 21 22 22 22 22 22 02 00 03 21 22 02 00 03 22 02 00 00 00 03 22 22 22 22 21 21 21 21 21 21 21 21 21 21 21 22 22 21 02 00 00 00 00 00 00 00 03 21 22 22 21 21 22 21 22 21 21 22 22 21 21 22 22 22 02 00 00 00 00 00 03 21 21 21 22 21 21 21 21 22 21 21 21 22 22 22 21 21 21 21 21 21 21 22 21 21 22 21 21 21 22 21 21 21 21 21
22 21 22 22 22 22 22 02 00 03 21 22 02 00 03 22 02 00 00 00 03 22 22 02 00 00 00 00 00 00 00 00 00 00 00 00 00 03 21 02 00 00 00 00 00 00 00 03 21 22 22 21 21 22 21 22 21 21 22 22 21 21 22 22 22 02 00 00 00 00 00 03 21 21 21 22 02 00 00 21 07 00 00 00 00 00 00 00 00 00 00 00 00 00 00 00 00 00 00 00 00 00 00 00 00 00 21
22 21 22 22 22 22 22 02 00 03 21 22 02 00 03 22 02 00 00 00 03 22 22 02 00 00 00 00 00 00 00 00 00 00 00 00 00 03 21 02 00 00 00 00 00 00 00 03 21 22 22 21 21 22 21 22 21 21 22 22 21 21 22 22 22 02 00 00 00 00 00 03 21 21 21 22 02 00 00 00 00 00 00 00 00 00 00 00 00 00 00 00 00 00 00 00 00 00 00 00 00 00 00 00 00 00 26
22 21 22 22 22 22 22 02 00 03 21 22 02 00 03 22 02 00 00 00 03 22 22 02 00 00 00 00 00 00 00 00 03 22 22 02 00 03 21 02 00 00 00 00 00 00 00 03 22 22 02 00 00 00 00 00 05 00 00 00 00 00 03 22 21 02 00 00 00 00 00 03 21 21 21 22 02 00 00 00 00 00 00 00 00 00 00 00 00 00 00 00 00 00 00 00 00 00 00 00 00 00 00 00 00 00 27
22 21 22 22 22 22 22 02 00 03 21 22 02 00 03 22 02 00 00 00 03 22 22 02 00 23 25 00 00 00 00 03 22 22 22 02 00 03 21 02 00 00 00 00 00 00 00 03 22 21 02 00 00 00 00 00 06 00 00 00 00 00 03 22 22 02 00 00 00 00 00 03 21 21 21 22 02 00 00 00 00 00 00 00 00 00 00 00 00 00 00 00 00 00 00 00 00 00 00 00 00 00 00 23 25 00 21
22 21 22 22 22 22 22 02 00 03 21 22 02 00 03 22 02 00 00 00 00 00 00 00 00 00 00 00 00 00 00 03 22 22 22 02 00 03 21 02 00 00 00 00 00 00 00 03 21 22 02 00 00 00 00 23 24 25 00 00 00 00 03 21 22 02 00 00 00 00 00 03 21 21 21 22 02 00 00 00 00 00 00 00 00 00 00 00 00 00 00 00 00 00 00 00 00 23 25 00 00 00 00 00 00 00 21
22 02 03 22 22 22 22 02 00 03 21 22 02 00 03 22 02 00 00 00 00 00 00 00 00 00 00 00 23 25 00 03 22 22 22 02 00 03 21 02 00 00 00 00 00 00 00 03 22 21 02 00 00 23 25 00 00 00 23 25 00 00 03 22 21 02 00 00 00 00 00 03 21 21 21 22 02 00 00 00 00 00 00 00 00 00 00 00 00 00 00 23 25 00 00 00 00 00 00 00 00 00 00 00 00 00 21
22 02 03 22 22 22 22 02 00 03 21 22 02 00 03 22 02 00 00 00 00 00 00 00 00 00 00 00 00 00 00 03 22 22 22 02 00 03 21 02 00 00 00 00 00 00 00 03 22 22 22 02 00 00 00 00 00 00 00 00 00 03 22 22 22 02 00 00 00 00 00 03 21 21 21 22 02 05 00 00 00 00 00 00 00 00 00 23 25 00 00 00 00 00 00 00 00 00 00 00 00 00 00 00 00 00 21
22 21 22 22 22 22 22 02 00 03 21 22 02 00 03 22 02 00 00 00 03 22 22 02 00 00 23 25 00 00 00 03 22 22 22 02 00 03 21 02 00 00 00 00 00 00 00 00 00 00 00 00 00 00 00 00 00 00 00 00 00 00 00 00 00 00 00 00 00 00 00 03 21 21 21 22 02 06 00 00 00 00 00 00 00 00 00 00 00 00 00 00 00 00 00 00 00 00 00 00 00 00 00 00 00 22 21
22 21 22 22 22 22 22 02 00 03 21 22 02 00 03 22 02 00 00 00 03 22 22 02 00 00 00 00 00 00 00 03 22 22 22 02 05 03 21 02 00 00 00 00 00 00 00 00 00 00 00 23 25 00 00 00 00 00 00 00 23 25 00 00 00 00 00 00 00 00 00 03 21 21 21 22 21 21 21 21 22 21 21 21 22 22 22 21 21 21 21 21 21 21 22 21 21 22 21 21 21 22 21 21 21 21 21
22 21 22 22 22 22 22 02 00 03 21 22 02 00 03 22 02 00 00 00 03 22 22 02 00 00 00 00 03 22 02 03 22 22 22 02 06 03 21 02 00 00 00 00 00 00 00 00 00 00 00 00 00 00 00 00 00 00 00 00 00 00 00 00 00 00 00 00 00 00 00 03 21 21 21 22 21 21 21 21 22 21 21 21 22 22 22 21 21 21 21 21 21 21 22 21 21 22 21 21 21 22 21 21 21 21 21
22 21 22 22 22 22 22 02 00 03 21 22 02 00 03 22 02 00 00 00 03 22 22 22 22 21 21 21 21 21 21 21 21 21 21 21 22 22 21 02 00 00 00 00 00 00 00 03 21 22 22 21 21 22 21 22 21 21 22 22 21 21 22 22 22 02 00 00 00 00 00 03 21 21 21 22 21 21 21 21 22 21 21 21 22 22 22 21 21 21 21 21 21 21 22 21 21 22 21 21 21 22 21 21 21 21 21
22 21 22 22 22 22 22 02 00 03 21 22 02 00 03 22 02 00 00 00 03 21 22 22 22 21 21 21 21 21 21 21 21 21 21 21 22 22 21 02 00 00 00 00 00 00 00 03 21 22 22 21 21 22 21 22 21 21 22 22 21 21 22 22 22 02 00 00 00 00 00 03 21 21 21 22 21 21 21 21 22 21 21 21 22 22 22 21 21 21 21 21 00 00 00 00 00 00 00 00 00 00 00 00 00 08 21
22 21 22 22 22 22 22 02 00 03 21 22 02 00 03 22 02 00 00 00 03 22 00 00 00 00 00 00 00 00 00 00 00 00 00 00 00 00 00 00 00 00 00 23 24 25 00 00 00 00 00 00 00 00 00 00 00 00 00 00 00 00 00 00 00 00 00 00 00 00 00 03 21 21 21 22 21 21 21 02 00 00 00 00 00 00 00 00 00 00 00 00 00 00 00 00 00 00 00 00 00 00 00 00 00 00 21
22 21 22 22 22 22 22 02 00 03 21 22 02 00 03 22 02 00 00 00 03 21 05 29 00 00 00 00 00 00 00 00 00 00 00 00 00 00 00 00 00 00 00 00 00 00 00 00 00 00 00 00 00 00 00 00 00 00 00 00 00 00 00 00 00 00 00 00 00 00 00 03 21 21 21 22 21 21 21 02 00 00 00 00 00 00 00 00 00 00 00 00 00 00 23 25 00 00 00 00 23 25 00 00 00 00 21
22 05 00 00 00 00 00 00 00 03 21 22 02 00 03 22 02 00 00 00 03 22 06 29 00 00 00 00 00 00 00 00 00 00 00 00 29 00 00 00 23 24 25 00 00 00 00 00 00 00 29 00 00 00 00 00 00 00 00 00 00 00 29 00 00 00 00 00 00 00 00 00 00 00 00 00 00 00 00 00 00 00 00 00 00 00 00 00 03 22 02 00 00 00 00 00 00 00 00 00 00 00 00 00 00 00 26
22 06 00 00 00 00 00 00 00 00 00 00 00 00 00 00 00 00 00 00 03 22 22 22 22 21 21 21 21 21 21 21 21 21 21 21 22 22 02 00 00 00 00 00 00 00 00 03 21 22 22 21 21 22 21 22 21 21 22 22 21 21 22 22 22 02 00 00 00 00 00 00 00 29 00 00 00 00 00 00 00 00 00 00 00 00 00 00 03 22 22 02 00 00 00 00 00 00 00 00 00 00 00 00 00 00 27
22 21 22 22 22 22 22 22 22 02 00 00 00 00 00 00 00 00 00 00 03 22 22 22 22 21 21 21 21 21 21 21 21 21 21 21 22 22 02 00 00 00 00 00 00 00 00 03 21 22 22 21 21 22 21 22 21 21 22 22 21 21 22 22 22 02 00 00 00 00 00 03 21 21 21 22 21 21 21 21 22 21 21 21 22 22 22 21 21 21 21 21 21 21 22 21 21 22 21 21 21 22 21 21 21 21 21

01 02 03 04 05 06 07 08 09 10 11 12 13 14 15 16 17 18 19 20 21 22 23 24 25 26 27 28 29 30 31 32 33 34 35 36 37 38 39 40 41 42 43 44 45 46 47 48 49 50 51 52 53 54 55 56 57 58 59 60 61 62 63 64 65 66 67 68 69 70 71 72 73 74 75 76 77 78 79 80 81 82 83 84 85 86 87 88 89 90 91 92 93 94 95 96 97 98 99 00 01 02 03 04 05 06 07