107
9
22 02 00 00 00 00 00 00 00 00 00 00 00 00 00 00 00 00 00 00 00 00 00 00 00 00 00 00 00 00 00 00 00 00 00 00 00 00 00 00 00 00 00 03 22 22 22 22 22 22 22 22 22 22 22 22 22 22 22 22 22 22 22 22 22 22 22 22 22 22 22 22 22 22 22 02 00 00 00 00 00 00 00 00 00 00 00 00 00 00 03 22 22 21 22 21 22 22 21 22 21 22 21 22 21 22 22 
21 02 00 00 00 00 00 00 00 00 00 00 00 00 00 00 00 00 00 00 00 00 00 00 00 00 00 00 00 00 00 00 00 00 00 00 00 00 00 00 00 00 00 00 03 22 22 22 22 22 22 22 22 22 22 22 22 22 22 22 02 00 00 00 00 00 00 00 00 00 03 22 22 22 22 02 00 00 00 00 00 00 00 00 00 00 00 00 00 00 00 03 22 21 22 22 07 00 00 00 00 00 00 00 00 03 22
22 02 00 00 00 00 00 00 00 00 00 00 00 00 00 00 00 00 00 00 00 00 00 00 00 00 00 00 00 00 00 00 00 00 00 00 00 00 00 00 00 00 00 00 00 00 00 00 03 22 22 22 22 22 22 22 22 22 22 22 02 00 00 00 00 00 00 00 00 00 00 00 03 22 22 02 00 00 00 00 00 00 00 00 00 00 00 00 00 00 00 00 03 22 21 22 22 02 00 00 00 00 00 00 00 03 22
21 02 00 00 00 00 00 00 00 00 00 00 00 00 00 00 00 00 00 00 00 00 00 00 00 00 00 00 00 00 00 00 00 00 00 00 00 00 00 23 24 25 00 00 00 00 00 00 00 00 00 03 22 22 22 22 22 22 22 02 00 00 00 00 00 00 00 00 00 00 00 00 00 00 00 00 00 00 00 00 00 00 00 00 03 21 02 00 00 00 00 00 00 03 22 22 22 02 00 00 00 00 00 00 00 00 26 
22 02 00 00 00 00 00 00 00 00 00 00 00 03 21 21 02 00 00 00 00 00 00 00 00 00 00 00 00 00 00 00 00 23 25 00 00 00 00 00 00 00 00 00 00 00 00 00 00 00 00 00 00 00 00 00 00 00 00 00 00 03 21 22 21 02 00 00 00 00 00 00 00 00 00 00 00 00 00 23 24 25 00 00 03 22 02 00 00 00 00 00 00 00 03 22 22 02 23 25 00 00 23 25 00 00 27 
22 02 00 00 00 00 00 00 00 00 03 21 22 21 22 22 02 00 00 00 00 00 00 00 00 00 00 00 00 00 00 00 00 00 00 00 00 00 00 00 00 00 00 03 21 22 21 21 02 00 00 00 00 00 00 00 00 00 00 00 00 03 22 21 22 02 00 00 00 00 00 00 00 00 00 00 00 00 00 00 00 00 00 00 03 22 02 00 00 00 00 00 00 00 00 00 00 00 00 00 00 00 00 00 03 21 21 
21 02 00 00 00 00 00 00 00 00 03 22 21 21 22 21 02 00 00 00 03 21 22 21 22 02 00 00 00 03 22 21 02 00 00 03 21 22 02 00 00 00 00 03 22 22 21 22 02 00 00 03 21 02 00 00 03 21 02 00 03 21 21 22 22 02 00 00 00 00 00 00 00 00 00 00 00 00 00 00 00 00 00 03 21 22 21 02 00 00 00 00 00 00 00 00 00 00 00 00 00 00 00 00 03 21 22
22 21 21 22 21 22 22 21 21 22 21 21 22 22 21 22 02 00 00 00 03 22 22 22 22 21 21 22 22 21 22 22 21 21 22 21 21 22 02 00 00 00 00 03 21 22 22 21 21 22 21 22 21 22 21 21 22 21 21 22 21 21 22 22 22 02 00 00 00 00 00 03 21 21 22 21 21 21 22 22 21 21 22 21 22 22 22 21 21 22 21 21 22 21 22 22 21 21 22 21 21 22 21 21 22 21 22 
22 21 21 22 21 22 22 21 21 22 21 21 22 22 21 22 02 00 00 00 03 22 22 22 22 21 21 22 22 21 22 22 21 21 22 21 21 22 02 00 00 00 00 03 21 22 22 21 21 22 21 22 21 22 21 21 22 21 21 22 21 21 22 22 22 02 00 00 00 00 00 03 21 21 22 21 21 21 22 22 21 21 22 21 22 22 22 21 21 22 21 21 22 21 22 22 21 21 22 21 21 22 21 21 22 21 22